6.
자료흐름도 4가지 구성요소
- 처리 Process : 원
- 자료흐름 Data Flow : 화살표
- 자료저장소 Data Store : 평행선
- 단말 Terminal : 사각형

9.
mock up : 정적
prototype : 동적

11.
정적구조: [ 클래스, 객체, 패키지, 컴포넌트, 복합구조, 배치]
동적구조: [ 유스케이스, 상태, 활동, 시퀀스(순차), 통신, 상호작용, 타이밍]

12. LOC기법 : 걍 나누셈

13.
단일 책임원칙 : 하나의 객체는 하나의 동작만의 책임을 가짐
개방-폐쇄의 원칙 : 클래스는 확장에 대해 열려 있어야 하며 변경에 대해 닫혀 있어야 한다.
리스코프 교체의 원칙 : 특정 메소드가 상위 타입을 인자로 사용할 때, 그 타입의 하위 타입도 문제 없이 작동해야 함
의존관계 역전의 원칙 : 상위 계층이 하위 계층에 의존하는 전통적인 의존관계를 반전(역전)시킴으로써 
상위 계층이 하위 계층의 구현으로부터 독립되게 할 수 있음

15.
소프트웨어 아키텍처의 설계과정
설계목표설정 -시스템 타입 결정 - 아키텍처 패턴 적용 - 서브시스템 구체화 - 검토

17.
소프트웨어 설계에서 자주 발생하는 문제에 대한 일반적이고 반복적인 해결 방법을 무엇이라고 하는가?
->디자인패턴

18.
럼바우 -> 객동기
부치 -> micro, macro
jacobson -> use case
wirfs-Brock -> 고객 명세서 평가

19.
EAI(Enterprise Application Integration): 기업 응용 프로그램 통합으로 기업용 응용 프로그램의 구조적 통합 방안을 가리킴
<FEP(Front-End Processor)>: 입력되는 데이터를 컴퓨터의 프로세서가 처리하기 전에 미리 처리하여 프로세서가 차지하는 시간을 줄여주는 프로그램이나 하드웨어
GPL(General Public License): 자유 소프트웨어 재단(OSF)에서 만든 자유 소프트웨어 라이선스
Duplexing: 이중화(데이터베이스의 회복 기법 중 가장 간단한 것)


